777777777777777
700112444210117
700002000200007
744002141204407
733302404203337
700000010000007
701458001584147
710400101004017
733302010203337
740102000201007
700012404210047
744012040210047
777777777777777