111111111111111111111111111111
100000000000000000000000000001
102222222222220002222222222221
100000000000000000000000000001
100000000000000000000000000001
104002222220330003302222220041
104000000003003030030000000041
104000000030000300003000000041
104000000030000000003000000041
104053535030000000003053535041
104000000030000000003000000041
104053535030000000003053535041
104000000003000000030000000041
104000000000300000300000000041
104000000000030003000000000041
104002222220003030002222220041
100000000000000300000000000001
102222222222220002222222222221
100000000000000000000000000001
111111111111111111111111111111