111111111111111111111111111111
170002000000000000000200000071
100000000033000000330000000001
104040400300300003003004040401
100404003000003300000300404001
100500000000005500000050000001
100500300000500005000053000001
100500000000000000000050000001
100503002005000000500050300001
100503000005000000500050300001
100500000000500005000250000001
100555350000005500000053555001
100000000000000000000000000001
100000403000000000000304000001
100000040006000000600040000001
100022004030000000030400020001
100000000400300003004000320001
100000000040003300040000000001
170000000000000000000000000071
111111111111111111111111111111