12 7 7 7 7 7 7 7 7 7 7 7 7 7 10
14 2 1 0 4 4 0 0 0 4 4 0 1 5 15
14 1 0 4 0 1 4 4 4 1 0 4 0 1 15
14 0 4 0 3 8 1 0 1 6 8 0 4 0 15
14 4 0 0 4 0 0 4 0 0 4 0 0 4 15
14 4 0 0 2 0 0 1 0 0 3 0 0 4 15
14 0 4 0 0 0 0 1 0 0 0 0 4 0 15
14 1 0 4 0 0 1 0 1 0 0 4 0 1 15
14 0 1 0 4 1 0 0 0 1 4 0 1 0 15
14 0 0 1 0 4 0 0 0 4 0 1 0 0 15
14 0 0 0 1 0 4 0 4 0 1 0 0 0 15
14 0 0 0 0 1 0 4 0 1 0 0 0 5 15
13 9 9 9 9 9 9 9 9 9 9 9 9 9 11